0000000000000000000000000000
011111p111111111111111111180
0111111111111111111111111180
0111111111111111111111111180
0111111111111111111111111180
0111111111111111111111111180
0111111111111111111111111880
0111111111111111111111111810
0111111111111111111111111t10
0000000000000000000000000000